1 1 2 2 2 1 2 2 1 1 2 2 2 2 2 2 2 2 2 2 2 2 2 2 2 2 2 2 2 2 1 1 2 1 12 12 12 1 1 6
1 1 12 12 12 6 10 15 3 4 11 0 10 11 10 16 0 11 11 11 0 14 11 0 11 10 0 14 11 10 5 6 15 3 12 12 12 2 1 6
1 2 12 12 12 4 11 10 0 14 11 0 0 14 11 14 0 14 11 0 11 0 0 14 11 14 11 14 0 0 5 6 16 10 14 14 14 11 5 6
6 11 14 14 0 0 11 11 14 11 0 11 14 11 14 11 0 11 14 11 14 11 19 11 14 14 11 14 11 0 5 6 11 14 0 14 14 0 5 6
6 11 14 14 14 14 0 0 8 9 11 14 11 8 9 0 0 11 0 11 0 11 17 0 0 8 9 11 14 11 5 6 10 14 11 14 11 0 5 6
6 0 14 14 14 11 14 0 5 6 11 15 11 5 4 0 0 11 14 11 14 11 10 11 0 3 6 0 0 11 5 6 11 14 14 14 18 14 5 6
6 11 14 0 0 11 14 0 5 6 16 11 8 4 0 14 11 11 11 14 11 14 14 0 0 11 3 9 11 14 5 6 16 14 0 14 11 14 5 6
6 11 0 0 14 11 10 0 5 6 11 8 4 0 14 11 14 0 11 11 14 0 14 11 14 11 14 3 9 0 5 6 11 0 0 14 11 0 5 6
1 7 7 7 7 7 7 7 1 1 7 6 11 14 0 14 11 0 11 14 11 14 11 0 11 11 0 14 3 7 1 1 9 11 11 11 8 7 1 1
1 2 2 2 2 2 2 2 2 2 1 6 11 14 0 14 11 14 11 0 11 0 0 11 11 0 11 14 11 5 1 2 4 0 11 11 3 2 1 1
6 10 11 11 0 11 11 14 14 10 5 6 11 0 11 11 0 14 11 14 11 14 11 0 11 0 11 14 11 5 6 0 11 11 14 11 0 11 5 6
6 11 11 0 11 11 0 14 0 14 3 4 11 0 11 0 14 8 7 7 7 7 7 9 11 0 11 0 0 3 4 11 0 11 11 0 0 11 5 6
6 11 14 0 14 11 0 11 14 0 0 11 14 11 0 11 10 5 1 1 1 1 1 6 11 14 11 0 0 14 11 14 11 14 11 14 11 14 5 6
6 14 11 14 11 11 0 0 11 14 11 14 0 14 11 14 11 5 1 1 1 1 1 6 11 11 0 14 11 0 11 11 11 0 11 14 11 14 5 6
6 0 11 11 0 11 11 11 14 11 8 9 11 14 0 14 11 5 1 1 1 1 1 6 11 0 11 11 11 11 0 14 11 11 11 14 0 11 5 6
6 11 11 11 11 14 11 14 11 14 5 6 11 11 0 0 11 5 1 1 1 1 1 6 11 14 11 0 11 8 9 0 0 11 14 11 14 11 5 6
6 0 14 11 0 11 0 11 0 11 5 6 11 14 0 14 11 3 2 2 2 2 2 4 11 10 11 0 11 5 6 0 0 11 14 11 11 11 5 6
6 11 14 11 0 11 11 0 14 11 5 6 11 14 11 0 11 14 11 0 0 0 11 11 0 11 0 11 14 5 6 11 0 11 11 0 10 11 5 6
6 11 19 11 0 0 0 11 14 11 5 6 11 0 11 14 11 14 11 11 11 11 0 14 11 11 11 14 11 5 6 11 0 0 11 11 14 11 5 6
6 11 17 16 0 11 11 14 11 14 5 6 11 14 11 0 0 14 11 14 11 14 11 0 11 0 11 14 0 5 6 11 15 11 10 11 15 0 5 6
6 11 0 11 0 11 14 0 15 11 5 6 11 0 11 10 0 0 11 14 11 10 11 14 11 14 11 14 0 5 6 10 11 0 16 11 14 11 5 6
1 7 7 7 7 7 7 7 7 7 1 1 7 7 7 7 7 7 7 7 7 7 7 7 7 7 7 7 7 1 1 7 7 7 7 7 7 7 1 1
6 6 6 6 6 6 6 6 6 6 6 6 6 6 6 6 6 6 6 6 6 6 6 6 6 6 6 6 6 6 6 6 6 6 6 6 6 6 6 6