1 2 2 2 2 1 2 2 1 1 2 2 2 2 2 2 2 2 2 2 2 2 2 2 2 2 2 2 2 2 2 2 2 2 12 12 12 2 1 6
6 0 12 12 12 0 0 15 5 6 11 0 0 11 0 16 0 11 11 11 0 0 11 0 11 0 0 14 11 0 0 0 15 0 12 12 12 0 5 0
6 0 12 12 12 0 11 11 5 6 11 0 0 14 11 14 0 14 11 0 11 0 0 14 11 14 11 14 0 0 0 0 16 0 14 14 18 11 5 0
6 11 14 14 0 0 11 11 5 1 7 7 7 7 7 9 0 11 14 11 14 11 18 11 18 14 11 14 11 0 0 0 11 14 0 14 14 0 5 0
6 11 14 14 14 14 0 11 3 2 2 2 2 2 1 6 0 11 0 11 0 11 17 0 0 0 0 11 14 11 0 0 0 18 11 14 11 0 5 0
6 0 14 14 14 11 14 0 0 0 11 15 11 0 5 6 0 11 14 11 14 11 0 11 0 0 0 0 0 11 0 0 11 18 14 14 18 14 5 0
6 11 14 0 0 11 14 0 0 0 16 11 0 0 3 1 9 11 11 14 11 14 14 0 0 11 0 0 11 18 0 0 16 14 0 14 11 14 5 0
6 11 0 0 14 11 0 0 0 0 11 0 0 0 14 3 1 9 11 11 14 0 14 11 14 11 14 0 0 0 0 0 11 0 0 14 11 0 5 0
6 0 0 0 0 0 0 0 0 0 0 0 11 14 0 14 5 6 11 14 11 14 11 0 11 11 0 14 0 0 0 0 0 11 11 11 0 0 5 0
6 0 0 0 0 0 0 0 0 0 0 0 11 14 0 14 5 6 11 0 11 0 0 11 11 0 11 14 11 0 0 0 0 0 11 11 0 0 5 0
6 0 11 8 7 7 7 7 7 7 7 7 7 7 7 7 1 6 11 14 11 14 11 0 11 0 11 14 11 0 0 0 11 11 14 11 0 11 5 0
6 11 11 3 2 2 2 2 2 2 2 2 2 2 2 2 1 1 7 7 7 7 7 7 7 7 7 7 7 7 7 7 7 7 9 0 0 11 5 0
6 11 14 0 14 11 0 11 14 0 0 11 14 11 0 11 5 1 2 2 2 2 2 2 2 2 2 2 2 2 2 2 2 2 4 0 11 14 5 0
6 14 11 14 11 11 0 0 11 14 11 14 0 14 11 0 3 4 0 0 0 0 0 0 11 11 0 14 11 0 11 11 11 0 11 14 11 14 5 0
6 0 11 11 0 11 11 11 14 11 0 0 11 14 0 14 11 0 0 0 0 0 0 0 11 0 11 11 11 11 0 14 11 11 11 14 0 11 5 0
6 11 11 11 11 14 11 14 11 14 0 0 11 11 0 0 11 0 0 0 0 0 0 0 11 14 11 0 11 0 0 0 0 11 14 11 14 11 5 0
6 0 14 11 0 11 0 11 0 11 0 0 11 14 0 14 11 0 0 0 0 0 0 0 11 0 11 0 11 0 0 0 0 11 14 11 11 11 5 0
6 11 14 11 0 11 11 0 14 11 0 0 11 14 11 0 11 18 11 0 0 0 11 11 0 11 0 11 14 0 0 11 0 11 11 0 0 11 5 0
6 11 18 11 0 0 0 11 18 11 0 0 11 0 11 18 11 14 11 11 11 11 0 14 11 11 11 14 11 0 0 11 0 0 11 11 14 11 5 0
6 11 17 16 0 11 11 18 11 14 0 0 11 14 11 0 0 14 11 14 11 14 11 0 11 0 11 18 0 0 0 11 15 11 0 11 15 0 5 0
6 11 0 11 0 11 14 0 15 11 0 0 11 0 11 0 0 0 11 14 11 0 11 14 11 14 11 14 0 0 0 0 11 0 16 11 18 11 5 0
1 7 7 7 7 7 7 7 7 7 1 1 7 7 7 7 7 7 7 7 7 7 7 7 7 7 7 7 7 1 1 7 7 7 7 7 7 7 1 1
6 6 6 6 6 6 6 6 6 6 6 6 6 6 6 6 6 6 6 6 6 6 6 6 6 6 6 6 6 6 6 6 6 6 6 6 6 6 6 6